..............................
..............................
.......#......................
.......#......................
.......#......................
.......#......................
.......#......................
.......#......................
.......#......................
.......##################.....
..............................
..............................
..............................
............#################.
............#.................
............#.................
............#.................
............#.................
............#.................
............#.................