..............................
..............................
..............................
..............................
..............................
.............#########........
.....................#........
.....................#........
.....................#........
.....................#........
.....................#........
..................####........
..............................
..........#...................
..........#...................
..........#...................
..........#...................
..........###########.........
..............................
..............................